深圳市福田区爱心盲人脚部按摩中心一九二七七|szs|mr|jb|zx
深圳市高熵文化传播有限公司|szs|gs|wh|gs
深圳星辰贸易有限公司|sz|cmy|my|gs
深圳市凤阳宏伟电声有限公司|szs|fyhw|ds|gs
深圳市恒力磨料有限公司生产部|szs|hl|ml|gs
深圳市非常智联科技有限公司研发部|szs|fczl|kj|gs
深圳市龙岗区平湖金鼎皮革商行|szs|jd|pg|sh
深圳市格灵电器有限公司|szs|gl|dq|gs
深圳辰科电子有限公司市场部|sz|ck|dz|gs
深圳亚特能电池科技有限公司|sz|ytn|dc|gs
深圳市华中通信研究院有限公司|szs|hz|tx|gs
香荔花园管理处深圳市农科物业管理有限公司|sz|xlhy|wygl|gs
深圳市南山区蛇口人民医院东区深圳市南山区蛇口人民医院兰园社区医疗站|szs|rmyy|yy|yy
盐田区海山街道办事处|hsjd|hsjd|bs|bsc
深圳市福田区三源电子零件经营部|szs|sy|dz|jyb
深圳市康联电子公司|szs|kl|dz|gs
深圳市龙岗区坪山镇玉隆塑胶厂|szs|yl|sj|sjc
深圳市宏发投资有限公司深圳市宏发投资有限公司|szs|hf|tz|gs
深圳市中圣轻钢组合房技术开发有限公司|szs|zs|qg|gs
深圳市运群五金塑胶有限公司|szs|yq|wj|gs
深圳市宇图龙电脑科技开发有限公司|szs|ytl|dn|gs
明治乳业贸易上海有限公司广州分公司深圳办事处|sz|mz|szbsc|gs
深圳增光电子有限公司|sz|zg|dz|gs
罗湖区翠竹街道办事处罗湖区翠竹街道办事处计生办|czjd|czjd|jdbsc|bsc
深圳市国土资源和房产管理局咨询信访常用名国土局罗湖土地税征收点|szs|gtzyhfcglj|fcgl|glj
深圳市南山区舒怡贸易商行|szs|sy|my|sh
深圳市钜兆科技有限公司销售业务部|szs|jz|kj|gs
深圳市良韶贸易有限公司|szs|ls|my|gs
深圳市披克电子有限公司|szs|pk|dz|gs
深圳市天宇力程光学材料有限公司|szs|tylc|gx|gs
深圳市深海捷科技有限公司|szs|shj|sh|gs
各省驻深圳办事处频道湖南省人民政府驻深圳办事处|sz|gs|rmzf|pd
深圳市伊恩特科技有限公司|szs|yet|kj|gs
深圳市文川实业有限公司深圳市文川实业有限公司|szs|wc|sy|gs
深圳宝安上合隆登电子厂|sz|shld|dz|dzc
深圳市易配齐实业有限公司|szs|ypq|sy|gs
深圳市万联智能卡技术有限公司|szs|ml|zn|gs
深圳肆野文化传播公司|sz|sy|wh|gs
深圳琦富瑞电子有限公司套管事业部|sz|qfr|dz|gs
深圳市磁通电子有限公司|szs|ct|dz|gs
广东深圳市方氏华泰印刷有限公司|sz|fsht|ys|gs
深圳市威准精密五金塑胶有限公司|szs|wz|jm|gs
深圳罗迪智科技有限公司销售部|sz|ldz|kj|gs
深圳市易图资讯有限公司|szs|yt|zx|gs
深圳市富泉贸易有限公司|szs|fq|my|gs
龙岗区供电局坑梓供电所|lgq|lg|gd|gds
深圳市威尔多利科技有限公司|szs|wedl|kj|gs
协庆精密科技深圳有限公司转二一四协庆精密科技深圳有限公司|sz|xq|jm|gs
深圳市宝果园精品水果俱乐部|szs|bgy|jp|jlb
深圳市永晟机电产品经营部|szs|yc|jd|jyb
深圳市满意搬迁公司|szs|my|bq|gs
深圳市钜晟金属材料有限公司业务部|szs|jc|js|gs
深圳市雅美乐家具有限公司深圳市雅美乐家具有限公司|szs|yml|jj|gs
一致药店总店深圳市一致医药连锁有限公司松岗卫民店|sz|yz|yd|yd
深圳市华志成塑胶模具制品有限公司|szs|hzc|sj|gs
深圳市雅仕快递国际有限公司|szs|ys|kd|gs
深圳市新光辉纸品包装有限公司|szs|xgh|zp|gs
深圳市海珑工作室|szs|hl|gz|gzs
南北药行皇御苑店|hy|nb|yx|yx
深圳市肯天通信技术有限公司三一七九四三|szs|kt|tx|gs
深圳市久仁科技有限公司|szs|jr|kj|gs
深圳赛格电子市场圳海电脑展销部|sz|sg|sc|sc
深圳市赛检科技有限公司销售部|szs|sj|kj|gs
深圳三源投资有限公司|sz|sy|tz|gs
深圳市电信局咨询投诉电信营业厅松岗营业厅|sg|szsdxj|dx|yyt
深圳市瑞福特信息技术有限公司|szs|rft|xx|gs
深圳市爱来利五金饰品有限公司|szs|all|wj|gs
深圳亿城实业有限公司|sz|yc|sy|gs
深圳滕科信科技有限公司|sz|tkx|kj|gs
琉璃时光spa概念美疗沙龙滨河店|bh|sg|ll|sl
深圳三力发展有限公司|sz|sl|fz|gs
深圳图腾商贸公司|sz|tt|sm|gs
香福江家具城福永店|fy|xfj|jj|jjc
深圳市栋森工程项目管理有限公司|szs|ds|gc|gs
深圳市鹏联门诊部|szs|pl|mz|mzb
深圳华美板材有限公司零零一|sz|hm|mc|gs
深圳市诺钧实业有限公司|szs|nj|sy|gs
深圳市信嘉和电子有限公司|szs|xjh|dz|gs
深圳市宝安客运中心有限公司深圳市宝安客运中心有限公司|szs|ba|ky|zx
深圳市宝安区松岗鑫发气动五金行|szs|xf|qd|wjx
深圳市旺达康环保科技有限公司|szs|wdk|hb|gs
深圳市合家乐家政有限公司|szs|hjl|jz|gs
深圳市富乐金电子科技有限公司|szs|flj|dz|gs
广东移动通信有限责任公司深圳公司原名深圳移动通信局龙观服务厅|gd|gd|txj|txj
深圳金士达电子科技有限公司|sz|jsd|dz|gs
深圳市现代贸易有限公司韩国现代汽车四s店深圳市现代贸易有限公司韩国现代汽车四s店|hg|xd|my|gs
深圳市奥源空调机电有限公司三二六五五九|szs|ay|kt|gs
深圳市鹰浦贸易有限公司|szs|yp|my|gs
雅士装饰制品深圳有限公司|sz|ys|zs|gs
深圳千之鲜工艺品有限公司|sz|qzx|gy|gs
深圳市尼普生科技公司|szs|nps|kj|gs
深圳蓝天电子有限公司|sz|lt|dz|gs
深圳科惠电子有限公司|sz|kh|dz|gs
深圳创之星实业有限公司|sz|cz|sy|gs
深圳市昂信科技发展有限公司营销部|szs|ax|kj|gs
深圳市双旺食品有限公司|szs|sw|sp|gs
威得客机械深圳有限公司|sz|wdk|jx|gs
百里臣便利店总部总机皇岗店|hg|blc|zj|zb
广东省深圳市金源科技有限公司|sz|jy|kj|gs
深圳市传绅贸易有限公司|szs|zs|my|gs
深圳市蓝德科技有限公司|szs|ld|kj|gs
深圳市爱希尔电子有限公司业务部|szs|axe|dz|gs
富建表业深圳有限公司|sz|fj|by|gs
深圳市机电金杯汽车贸易有限公司|szs|jb|qm|gs
深圳市卡斯特企业管理顾问公司|szs|kst|qygl|gs
沙湾派出所|sw|sw|pcs|pcs
深圳圣科数码科技有限公司|sz|sk|sm|gs
深圳市宝安区大浪圣民源工艺制品厂|szs|smy|gy|zpc
深圳市金益达实业发展有限公司|szs|jyd|sy|gs
深圳市立阳包装材料有限公司|szs|ly|bz|gs
深圳市宏艺数码科技有限公司|szs|hy|sm|gs
深圳市三井木科技有限公司商务部深圳市三井木科技有限公司|szs|sjm|kj|gs
深圳市致远通科技有限责任公司|szs|zyt|kj|gs
深圳市锦发铜铝有限公司松岗分公司|szs|jf|tl|gs
深圳市仁福首饰有限公司|szs|rf|ss|gs
深圳鸿泰兴科技有限公司|sz|htx|kj|gs
深圳市琦鑫源电子有限公司|szs|qxy|dz|gs
深圳市三江达实业发展有限公司|szs|sjd|sy|gs
深圳协进模具配件有限公司|sz|xj|mj|gs
深圳市东方中药园投资发展有限公司中药饮片厂|szs|df|zyyp|yxgs
深圳市快达航空服务有限公司|szs|kd|hk|gs
深圳市永兴通电子有限公司|szs|yxt|dz|gs
深圳市宝安区环保科技服务中心|szs|ba|hb|zx
深圳市华凯物流有限公司业务部|szs|hk|wl|gs
深圳市格扬金属制品厂|szs|gy|js|zpc
深圳市维嘉信息技术有限公司|szs|wjx|js|gs
深圳市比速数码科技有限公司|szs|bs|sm|gs
深圳市福田区一诺金电子商行|szs|ynj|dz|sh
深圳威特瑞科技有限公司|sz|wtr|kj|gs
深圳市筑磊实业公司|szs|zl|sy|gs
深圳市惠宝酒店用品有限公司|szs|hb|jd|gs
深圳市博客商务咨询有限公司|szs|bk|sw|gs
乔舒亚软件科技深圳有限公司|sz|qsy|rj|gs
深圳市鼎光伟业科技有限公司|szs|dg|kj|wy
深圳盛泰电子公司|sz|st|dz|gs
深圳市艺精工五金弹簧有限公司|szs|yjg|jg|gs
深圳市创速物流有限公司|szs|cs|wl|gs
深圳市明和堂药业连锁有限公司|szs|mht|yy|ls
深圳市朗天通信设备有限公司|szs|lt|tx|gs
深圳市博汇通实业有限公司|szs|bht|sy|gs
星达化工有限公司深圳办事处|sz|dhg|szbsc|gs
深圳典洋国际货运代理有限公司市场业务部|sz|dy|gjhy|gs
深圳市鹏灏不干胶有限公司|szs|ph|bgj|gs
深圳正大升实业有限公司|sz|zds|sy|gs
麦当劳深圳市麦当劳餐厅有限公司总部大梅沙店|sz|mdl|ct|ct
深圳市松竹苑日本料理有限公司|szs|szy|ll|gs
深圳市新梅园饮食策划管理公司龙华四季大酒店订座深圳市新梅园饮食策划管理公司龙华四季大酒店订座|szs|xmy|jd|gs
泰康人寿保险股份有限公司深圳分公司四|sz|tk|rsbx|gs
深圳报业集团发行有限公司三四七七三三平湖发行站|ph|szbyjt|fx|jt
美固电子深圳有限公司|sz|mg|dz|gs
福田区香蜜湖街道竹园社区工作站|xmhjd|zy|gz|gzz
深圳市碧海湾高尔夫俱乐部有限公司总机深圳市碧海湾高尔夫俱乐部有限公司|szs|bhw|zj|gs
深圳市景塑实业有限公司|szs|js|sy|gs
深圳市星光盾科技发展有限公司|szs|gd|kj|gs
宝安区松岗红星浩源手袋厂市场部三线行政部|baq|b|sd|scb
振兴装饰工程部|zx|zx|gc|gcb
深圳市罗曼迪卡家具有限公司|szs|lmdk|jj|gs
深圳龙岗区龙岗溢兴顺制衣厂|lgq|yxs|zy|zyc
妍丽化妆品中心花园城店|hyc|yl|hz|zx
深圳龙润万能彩印机械有限公司|sz|lrwn|cy|gs
深圳洁琪纺织品有限公司|sz|jq|fz|gs
深圳深雅包装制品有限公司业务部|sz|sy|bz|gs
大民装饰品深圳有限公司|sz|dm|zs|gs
深圳科华电器有限公司|sz|kh|dq|gs
深圳市展鸿达五金制品有限公司|szs|zhd|wj|gs
交通银行股份有限公司深圳分行交通银行车公庙支行信贷理财|sz|jtyh|jt|yh
深圳市华之誉国际货运代理有限公司业务部|szs|hzy|gjhy|gs
深圳鸿洲置业集团有限公司|sz|hz|zy|jt
深圳轻工业品进出口公司鞋帽部|sz|qgy|qg|gs
深圳国华华宇制品厂|sz|ghhy|zp|zpc
深圳三二一科技发展公司|sz|jfz|fz|seyk
深圳市宝安区西乡新正虹塑胶电子厂|szs|xzh|sj|dzc
中信银行深圳分行总行营业厅|zx|zxyh|fh|fh
深圳市梵石珠宝有限公司|szs|fs|zb|gs
深圳市韵达速递有限公司爱华站|szs|yd|sd|gs
深圳市宝安新安新和电子厂|szs|xh|dz|dzc
黄贝岭中村上村管理处深圳靖轩物业公司|sc|zc|gl|gs
深圳市恒发塑胶有限公司|szs|hf|sj|gs
莉施莱五金塑胶制品深圳有限公司|sz|lsl|wj|gs
深圳市瑞银投资顾问有限公司|szs|ry|tz|gs
深圳市万龙飞实业有限公司|szs|wlf|sy|gs
深圳市普斯科信息技术有限公司|szs|psk|xx|gs
深圳市欢声达通讯有限公司业务部|szs|hsd|tx|gs
深圳市崇海电子有限公司|szs|ch|dz|gs
深圳小丫贸易公司|sz|xy|my|gs
深圳市奥泰电子有限公司业务部|szs|at|dz|gs
深圳大地塑胶有限公司|sz|dd|sj|gs
深圳飞博创光通讯股份有限公司|sz|fbcg|tx|gs
深圳市福波贸易有限公司|szs|fb|my|gs
深圳市三邦化工有限公司|szs|sb|hg|gs
深圳市成功废旧金属回收有限公司|szs|cg|fj|gs
永泰辉印刷深圳有限公司|sz|yth|ys|gs
广东省深圳市佳诚电子有限公司|sz|jc|dz|gs
深圳市东洋通讯有限公司|szs|dy|tx|gs
深圳市交运工程有限公司|szs|jy|gc|gs
深圳友联信息有限公司|sz|yl|xx|gs
深圳迪蒙科技有限公司|sz|dm|kj|gs
深圳市超艺建筑装饰工程有限公司|szs|cy|jz|gs
深圳凯达海棉制品厂业务部|sz|kd|hm|zpc
深圳恒富威电子机械有限公司|sz|hfw|dz|gs
深圳兴威隆电子制品厂|sz|xwl|dz|zpc
深圳洋美粘扣带魔术贴有限公司|sz|ym|zk|gs
深圳市海博进出口有限公司|szs|hb|ck|gs
昆杉深圳科技发展有限公司|sz|ks|kj|gs
深圳市创电实业有限公司|szs|cd|sy|gs
深圳市家福特建材超市有限公司合肥分公司|szs|jft|jc|cs
深圳市富利凯包装制品有限公司flk|szs|flk|bz|gs
深圳市和盛达实业有限公司|szs|hsd|sy|gs
深圳市龙岗田段心股份合作公司三五六三二七|szs|tdx|gf|gs
深圳市良誉注塑科技有限公司|szs|ly|zs|gs
深圳大中天源贸易公司|sz|dzty|my|gs
正威科技深圳有限公司正威国际集团有限公司|sz|zw|kj|gs
深圳丽辰进出口贸易有限公司|sz|lc|ck|gs
深圳市新富源实业发展有限公司|szs|xfy|sy|gs
深圳市天涯礼品有限公司苏州分部|szs|ty|lp|gs
深圳利华印刷器材商行|sz|lh|ys|sh
深圳市志诚橡塑制品厂|szs|zc|xs|zpc
深圳市科陆电子有限公司科研处|szs|kl|dz|gs
佳利来实业深圳有限公司总部|sz|jll|sy|gs
富华窗帘灯饰城|fh|fh|ds|dsc
沙井人民医院新二社区健康服务中心|sj|rmyy|sqjk|yy
深圳市金诺得汽车贸易有限公司|szs|jnd|qm|gs
深圳碧海园林花艺有限公司|sz|bh|hy|gs
深圳雪儿服饰经营部|sz|xe|fz|jyb
深圳市成殷高新技术有限公司|szs|cy|gx|gs
深圳市晶一水晶工艺礼品有限公司|szs|jy|sj|gs
兴华宾馆订房二星服务台|xh|xh|df|fwt
深圳市韵达通电子有限公司市场部站长|szs|ydt|dz|gs
深圳都会挺点健康美胸美体连锁机构|sz|dhtd|jk|ls
深圳市南强电子有限公司业务部|szs|nq|dz|gs
深圳市新永鸿塑胶制品有限公司|szs|xyh|sj|gs
中国石化新洲加油站|xz|zgsh|sh|jyz
日立信息系统上海有限公司深圳分公司|sz|rl|xx|gs
深圳市口岸中国旅行社有限公司总部口岸旅行社公明营业部|szs|zglxs|lx|gs
深圳市金士通船务代理有限公司货运分公司|szs|jst|cw|gs
新安街道市政服务中心|xa|xa|sz|zx
深圳市智鼎装饰有限公司|szs|zd|zs|gs
深圳市中影南国电影城有限公司排期查询业务电话|szs|zyng|dyc|gs
深圳市佳美星科技有限公司|szs|jm|kj|gs
深圳市华中力机械设备有限公司采购部|szs|hzl|jx|gs
深圳京华电子股份有限公司|sz|jh|dz|gs
深圳美域文化传播有限公司|sz|my|wh|gs
深圳市祥辉纺织香港贸易有限公司|szs|xh|hk|gs
深圳市万生堂保健用品贸易有限公司|szs|wst|bj|gs
深圳祥龙塑胶颜料有限公司|sz|xl|sj|gs
勤阳科技深圳有限公司|sz|qy|kj|gs
福成国际货运代理深圳有限公司|sz|fc|gjhy|gs
平方超市沙嘴一店|sz|pf|cs|yd
深圳市新创益投资有限公司|szs|xcy|tz|gs
深圳市大成三众实业发展有限公司|szs|dcsz|sy|gs
深圳市优资福科技有限公司市场部|szs|yzf|kj|gs
深圳百联科技有限公司|sz|bl|kj|gs
深圳市中立创轴承有限公司业务部|szs|zlc|zc|gs
深圳市松岗稳振纸品有限公司|szs|sgwz|zp|gs
深圳市百度西数码耗材有限公司|szs|bdx|sm|gs
深圳市科广电自动化设备有限公司|szs|kgd|zd|gs
深圳市盛德福科技发展有限公司|szs|sdf|kj|gs
深圳市东北人风味连锁饺子坊南山店订座中航店订座|szs|dbr|fw|ls
深圳好运达化工商行|sz|hyd|hg|sh
园岭新村管理处深圳彩云居物业管理有限公司|yl|xc|wygl|gs
深圳市蔚达光电有限公司|szs|wd|gd|gs
深圳久实电子有限公司|sz|js|dz|gs
深圳市冠准检测实验室|szs|gz|jc|sys
北方饺子馆水贝店|sb|bfjzg|jzg|jzg
深圳市尚彩纸制品有限公司|szs|sc|zz|gs
深圳市湘晨机械有限公司|szs|xc|jx|gs
亚洲大药房笋岗店亚洲医药公司笋岗店岗厦东店|sg|yz|yf|gs
深圳观兰创峰木器制作公司|sz|glcf|mq|gs
深圳市晨创电子有限公司|szs|cc|dz|gs
振兴模具五金厂|zx|zx|wj|wjc
深圳市邻通科技有限公司|szs|lt|kj|gs
深圳市合思科技有限公司|szs|hs|kj|gs
深圳市好康来实业有限公司市场销售部|szs|hkl|sy|gs
承扬软件上海有限公司深圳分公司|sz|cy|rj|gs
深圳市沃达丰电子科技有限公司|szs|wdf|dz|gs
和民餐饮深圳有限公司|sz|hm|cy|gs
深圳丰汉实业有限公司营销部|sz|fh|sy|gs
深圳市宝矿通广告传媒有限公司|szs|bkt|gg|gs
深圳市金徽达五金有限公司|szs|jhd|wj|gs
深圳太极软件公司|sz|tj|rj|gs
深圳市北方锋华商贸有限公司销售部|szs|bffh|sm|gs
深圳市罗湖区企业离休干部管理服务中心|szs|lx|qy|zx
东来顺饭庄文锦店南山店订座|wj|dls|fz|fz
深圳市海冠物流有限公司业务部|szs|hg|wl|gs
中国人寿保险有限公司深圳市分公司|sz|zgrs|rs|gs
深圳大全发轴承有限公司|sz|dqf|zc|gs
南北药行城市山林店|sl|nb|yx|yx
深圳网视通数码科技有限公司|sz|wst|sm|gs
深圳甜心宝贝玩具礼品有限公司|sz|txbb|wj|gs
深圳金达裕皮边油有限公司|sz|jdy|pby|gs
中铁二局机械筑路工程有限公司深圳市分公司|sz|zt|jx|ej
深圳晶利来磁性材料厂|sz|jll|cx|clc
深圳市福田区光纪窗帘加工店新洲销售处|szs|gj|cl|jgd
深圳市华力特电气股份有限公司|szs|hlt|dq|gs
深圳市同天冠强网络科技有限公司|szs|ttgq|wl|gs
俄罗斯驻深圳办事处|sz|els|szbsc|bsc
深圳市德亿电子技术有限公司|szs|dy|dz|gs
深圳艺艺科技创新有限公司|sz|yy|kj|gs
蛇口人民医院南光社区健康服务中心|sk|rmyy|sqjk|yy
深圳招商供电有限公司工业八路营业厅原名蛇口工业区供电公司后海营业厅|sz|zs|zs|gs
深圳仕佳光缆技术有限公司|sz|sj|gl|gs
罗湖区肥妹妹烧腊快餐店|lhq|fmm|sl|kcd
蓝白快餐燕南总店|yn|lb|kc|zd
深圳市点定贸易有限公司|szs|dd|my|gs
深圳市威仕利贸易有限公司|szs|wsl|my|gs
深圳市加京电器有限公司|szs|jj|dq|gs
深圳鸿盛数码色彩科技有限公司|sz|hs|sm|gs
深圳市宁佳置业有限公司|szs|nj|zy|gs
深圳普济门诊部总机爱康国宾深圳普济门诊部|sz|pj|mz|mzb
深圳威乐斯汽车工作室|sz|wls|qc|gzs
深圳市福田区伟创新销售部|szs|wcx|cx|xsb
深圳市凯隆电子有限公司经营部售后服务部|szs|kl|dz|gs
深圳市凯之缘电子有限公司|szs|kzy|dz|gs
麦当劳深圳市麦当劳餐厅有限公司总部光华店|sz|mdl|ct|ct
深圳市金桥纸制品包装有限公司|szs|jq|bz|gs
深圳市百胜隆通讯有限公司|szs|bsl|tx|gs
深圳市大鼎实业有限公司盐田分公司|szs|dd|sy|gs
深圳新世纪半导体照明有限公司|sz|xsj|zm|gs
深圳市冠磊基础工程有限公司总机传真|szs|gl|jc|gs
深圳市飞毛腿技术软件有限公司|szs|fmt|js|gs
深圳市博世防水工程服务部工程部|szs|bsfs|fs|fwb
克丽缇娜总店岁宝百货店|sb|kltn|bh|zd
深圳市阿克莱斯软件技术有限公司|szs|akls|rj|gs
深圳市奥速达物流有限公司|szs|asd|wl|gs
深圳江友华锅炉配件公司|sz|jyh|gl|gs
深圳市昌顺达机械设备有限公司|szs|csd|jx|gs
深圳市必达展览装饰工程有限公司一三五零三七五|szs|bd|zl|gs
麦当劳深圳市麦当劳餐厅有限公司总部梅林店|sz|mdl|ct|ct
深圳市金煌科技有限公司|szs|jh|kj|gs
深圳市国发纺织品有限公司|szs|gf|fz|gs
人人乐超市总部锦花购物广场店锦花购物广场店|rry|jh|cs|cs
深圳希诺礼品有限公司|sz|xn|lp|gs
深圳市孟源物流有限公司|szs|my|wl|gs
深圳市瑞骑讯达电子有限公司|szs|rqxd|dz|gs
深圳市锦荣表面材料厂|szs|jr|bm|clc
深圳市屏蔽导电胶带有限公司|szs|pb|dd|gs
深圳市木木电脑工作室|szs|mm|dn|gzs
深圳市狮子头电子科技有限公司|szs|szt|dz|gs
深圳市大族激光科技股份有限公司马家龙分公司|szs|dz|jg|gs
宝安区水务局养护队养护队|baq|yhd|sw|swj
稳润光电深圳办事处|sz|wr|szbsc|bsc
深圳移动时代有限公司|sz|sd|yd|gs
深圳市云飞龙特种气体有限公司销售部|szs|yfl|tz|gs
深圳市创益辉实业有限公司销售部|szs|cyh|sy|gs
深圳市天方达软件开发有限公司|szs|tfd|rj|gs
深圳市中展生物科技开发公司|szs|zz|sw|gs
深圳同兴晟实业公司|sz|txc|sy|gs
宝安区松岗街道大田洋社区警务室|sgjd|dty|sq|jws
英赛特文具纸品有限公司布吉分公司|bj|yst|wj|gs
深圳利富勤塑胶制品有限公司|sz|lfq|sj|gs
飞阳国际香港有限公司深圳公司|sz|fy|hk|gs
深圳市铭昱达电子有限公司|szs|myd|dz|gs
深圳市耀鹏精密五金制品有限公司|szs|yp|jm|gs
宝安区福永街道成人文化技术学校办公室会计类培训|fyjd|kjl|bgs|xx
深圳市龙驰实业有限公司销售|szs|lc|sy|gs
深圳市润智知识产权服务有限公司|szs|rz|cq|gs
深圳市龙岗区龙祥文具包装劳保店|szs|lx|wj|lbd
富基电脑科技深圳有限公司|sz|fj|dn|gs
深圳科敏电子有限公司|sz|km|dz|gs
深圳市中力通数码有限公司|szs|zlt|sm|gs
深圳市海贝尔电子有限公司国际贸易部|szs|hbe|dz|gs
深圳市天昶汽车租赁有限公司|szs|tc|qc|gs
深圳市活力斯实业有限公司|szs|hls|sy|gs
深圳乐毅科技有限公司|sz|ly|kj|gs
信邦电子深圳有限公司|sz|xb|dz|gs
深圳市沃尔核材股份有限公司市场部|szs|we|hc|gs
深圳市镭之光电子有限公司|szs|lz|gd|gs
宝安区西乡庆丰源包装制品厂|baq|qfy|bz|zpc
深圳市灵诚电子有限公司|szs|lc|dz|gs
深圳市为先电子有限公司三五二零七九|szs|wx|dz|gs
深圳市数康视频电子有限公司|szs|sk|sp|gs
深圳市佛莱邦科技有限公司销售部|szs|flb|kj|gs
深圳龙岗区亿诚电气经营部|lgq|yc|dq|jyb
深圳市长利科技有限公司|szs|zl|kj|gs
深圳市喜昌利科技有限公司|szs|xcl|kj|gs
深圳盟泰智能机电科技有限公司|sz|mt|zn|gs
深圳宝安区沙井新桥古氏发展有限公司|baq|xqgs|fz|gs
深圳市国信金属材料公司|szs|gx|js|gs
深圳市傲天新信息技术有限公司|szs|atx|xx|gs
深圳市豪恩实业有限公司|szs|he|sy|gs
深圳市联通纺织品有限公司|szs|lt|fz|gs
深圳市天和国际货运代理有限公司|szs|th|gjhy|gs
深圳市鹏锦生投资发展有限公司|szs|pjs|tz|gs
深圳市裕泰五金加工厂|szs|yt|wj|gc
深圳市城利士电子有限公司|szs|cls|dz|gs
深圳天勤汽车用品有限公司|sz|tq|qc|gs
万进达电池科技有限公司深圳办|sz|mjd|dc|gs
深圳建元信贸易有限公司|sz|jyx|my|gs
深圳市翔能环境科技系统有限公司|szs|xn|hj|gs
荣华饼家龙城街店|lc|rh|bj|bj
深圳华育昌国际科教开发有限公司|sz|hyc|gj|gs
深圳市永鲜宝实业有限公司|szs|yxb|sy|gs
深圳市巨贤塑胶五金制品有限公司|szs|jx|sj|gs
深圳市威胜科技有限公司|szs|ws|kj|gs
富瑰园管理处深圳市富通物业管理有限公司|sz|fgy|wygl|gs
深圳市旭众实业股份有限公司|szs|xz|sy|gs
深圳龙华毛家饭店|sz|lhmj|fd|fd
深圳市松雷商贸有限公司|szs|sl|sm|gs
宝安园林绿化公司|ba|ba|yl|gs
深圳市逸达安防科技有限公司销售部|szs|yd|af|gs
深圳市新明发汽车维修护理中心深圳市新明发汽修护理中心|szs|xmf|qcwx|zx
深圳市远利电子厂|szs|yl|dz|dzc
深圳市昌达电子科技有限公司|szs|cd|dz|gs
飞天达科技深圳发展有限公司|sz|ftd|kj|gs
深圳市龙岗区平湖镇赣协力精密金属制造加工部|szs|gxl|jm|jgb
深圳市正泽模塑科技有限公司|szs|zz|ms|gs
深圳市蓝魔数码科技有限公司一售后部|szs|lm|sm|gs
深圳市海瑞达电子有限公司|szs|hrd|dz|gs
深圳市倍诺防伪技术有限公司|szs|bn|fw|gs
深圳市同方多媒体科技有限公司总机|szs|tf|mt|gs
深圳市南和华毅塑胶制品有限公司|szs|nhhy|sj|gs
深圳市龙岗区布吉岗头升辉玩具厂|szs|gtsh|wj|wjc
深圳祥祺物业管理有限公司|sz|xq|wygl|gs
深圳市亨利精品数码批发行|szs|hl|jp|pfx
深圳市飞扬信息科技有限公司|szs|fy|xx|gs
深圳市明鑫高分子技术有限公司市场部|szs|mx|js|gs
深圳市宝安区西乡顺锦达五金经营部|szs|sjd|wj|jyb
深圳市万利丰五金塑胶制品有限公司|szs|wlf|wj|gs
飞阳深圳工艺经销公司|sz|fy|gy|gs
深圳市天方房地产有限公司|szs|tf|fdc|gs
深圳市日亚照明工厂|szs|ry|zm|gc
深垦六联贸易有限公司|ll|sk|my|gs
深圳信成电子有限公司|sz|xc|dz|gs
深圳市宝安区川星工量具经营部|szs|b|lj|jyb
深圳市巨龙五金贸易有限公司|szs|jl|wj|gs
深圳常青数码科技有限公司|sz|cq|sm|gs
深圳市益升印刷包装机械有限公司|szs|ys|ys|gs
广东揭阳市仙桥镇洋内工业区荣昌五金塑料制品厂|gd|gd|jys|zpc
天光医疗深圳有限公司|sz|tg|yl|gs
深圳市快易通信息技术有限公司|szs|kyt|tx|gs
深圳市钲昊印刷有限公司|szs|zh|ys|gs
深圳市中谷泰实业有限公司|szs|zgt|sy|gs
深圳市鲜粉人家实业发展有限公司凤凰店|szs|xfrj|sy|gs
深圳爱普连电子科技有限公司|sz|apl|dz|gs
深圳中深汽车用品公司|sz|zs|qc|gs
深圳市安托山投资发展有限公司咨询|szs|ats|tz|gs
展恒餐具制品深圳有限公司|sz|zh|cj|gs
深圳欣旭电子有限公司|sz|xx|dz|gs
深圳市康普盾电子科技有限公司深圳市康普盾电子科技有限公司|szs|kpd|dz|gs
深圳星原科技有限公司|sz|ykj|kj|gs
名丽坊国际美容中心福田分店报纸信息名丽坊国际美容中心水围店|ft|mlf|gj|zx
深圳市广聚能源股份有限公司二级有号码蛇口门市|szs|gj|ny|gs
深圳市曦毅科技有限公司|szs|xy|kj|gs
深圳市海曼科技有限公司|szs|hm|kj|gs
深圳振华集团有限公司总办|sz|zh|zb|gs
深圳市爱沃生电子有限公司南山|szs|aws|dz|gs
深圳东盛行润滑油公司|sz|dsh|rh|gs
深圳龙华宏鹰粘材制品有限公司|sz|hync|zp|gs
深圳市小巫女精品时尚有限公司|szs|xwn|jp|gs
深圳市东顺机械有限公司市场及销售部|szs|ds|jx|gs
深圳凌傲服饰有限公司|sz|la|fz|gs
深圳日升化工有限公司|sz|rs|hg|gs
深圳玉峰实业有限公司|sz|yf|sy|gs
深圳波鸿实业有限公司|sz|bh|sy|gs
深圳市弘盛净化科技有限公司|szs|hs|jh|gs
深圳市广程广告有限公司|szs|gc|gg|gs
深圳市鑫铭机械设备有限公司|szs|xm|jx|gs
深圳凌盛贸易公司|sz|ls|my|gs
深圳市众烨光源照明有限公司|szs|zy|gy|gs
深圳市中康福药业有限公司仓库|szs|zkf|yy|gs
百度中国有限公司深圳分公司业务咨询|sz|bdzg|yw|gs
深圳海拓实业有限公司|sz|ht|sy|gs
深圳佳新环保有限公司|sz|jx|hb|gs
深圳市金得利模特儿衣架有限公司业务部|szs|jdl|mt|gs
龙岗区东升学校龙岗区东升学校|lgq|ds|xx|xx
深圳市汉辉塑胶制品有限公司业务部|szs|hh|sj|gs
深圳市欧瑞吉科技有限公司|szs|orj|kj|gs
深圳国微技术有限公司mtv营销部|sz|gw|js|gs
龙腾神州国际物流有限公司|lt|ltsz|gj|gs
深圳志达印刷有限公司|sz|zd|ys|gs
深圳中施机械设备有限公司售后服务|sz|zs|jx|gs
奥林巴斯深圳工业有限公司|sz|albs|gy|gs
光大银行深圳分行景田支行|sz|gd|yh|yh
深圳市三秋科技开发有限公司|szs|sq|kj|gs
深圳市好加科技有限公司led|szs|hj|kj|gs
深圳市玮佳盛印刷有限公司|szs|wjs|ys|gs
深圳恒烽达模特衣架厂|sz|hfd|mt|yjc
李宁体育专卖新白马店|bm|ln|ty|zm
深圳市同飞达智能系统有限公司|szs|tfd|zn|gs
深圳宋式科技有限公司|sz|ss|kj|gs
骏腾康五金制品深圳有限公司|sz|jtk|wj|gs
深圳市安盛电子有限公司|szs|as|dz|gs
铁通深圳分公司服务热线布吉营业部|sz|tt|fw|gs
深圳市鹏华企业管理顾问有限公司|szs|ph|qygl|gs
深圳时代数码公司|sz|sd|sm|gs
联合证券有限责任公司服务热线四通证券益田路营业部咨询|yt|st|lh|gs
维迪兴业科技深圳有限公司|sz|wdxy|kj|gs
深圳凌志电子科技有限公司|sz|lz|dz|gs
深圳市通天地旧手机通讯市场有限公司总机|szs|ttd|sj|sc
罗湖信息中心|lh|lh|xx|zx
深圳顺德塑胶制品厂|sz|sd|sj|zpc
新世纪技工学校新桥分校|xq|xsj|jgxx|xx
深圳市天力胶粘带有限公司销售部|szs|tl|jz|gs
深圳伟健机械制造有限公司|sz|wj|jx|gs
深圳市知本物业管理有限公司|szs|zb|wygl|gs
深圳市亚宇鸿光电科技有限公司业务部|szs|yyh|gd|gs
深圳市普盛茶业有限公司|szs|ps|cy|gs
深圳长荣昌电子有限公司|sz|crc|dz|gs
和平广场管理处崇德物业公司七三三六九|hp|hp|gl|gs
面点王总店万象岁宝店|sb|wx|md|zd
晶硅光电深圳有限公司|sz|jg|gd|gs
深圳市雪皓电子制品厂|szs|xh|dz|zpc
深圳市智勇达实业有限公司|szs|zyd|sy|gs
华夏银行深圳分行布吉支行布吉支行|sz|hx|yh|yh
深圳市麦捷微电子科技股份有限公司|szs|mjw|dz|gs
深圳市比格威科技有限公司|szs|bgw|kj|gs
深圳市赛诺威信息咨询有限公司|szs|snw|xx|gs
深圳市柏瑟教育咨询有限公司总部深圳市柏瑟教育咨询有限公司|szs|bs|jy|gs
深圳市友车友汽车销售服务有限公司深圳市友车友汽车销售服务有限公司|szs|ycy|qc|gs
龙波通讯坪山旗舰店|ps|lb|tx|qj
深圳市福田区巅峰微科电子经营部|szs|dfwk|dz|jyb
布吉农批市场管理处|bj|bj|sc|sc
深圳市祥旺实业有限公司|szs|xw|sy|gs
深圳市深资源实业有限公司|szs|szy|zy|gs
深圳市虹盛电子有限公司业务部|szs|hs|dz|gs
中国工商银行深圳市分行工商银行华强支行行政公司业务|sz|zggsyx|gs|yh
深圳南山区科技创业服务中心|nsq|ns|kj|zx
卡顿女性发型顾问连锁南油店|ny|kd|fx|ls
深圳市筑乐科技有限公司|szs|zl|kj|gs
深圳一电电池技术有限公司深圳一电电池技术有限公司|sz|yd|dc|gs
深圳市宝安区沙井新光塑胶五金制品厂|szs|xg|sj|zpc
深圳市建艺市政工程公司|szs|jy|sz|gs
深圳锐发科技有限公司|sz|rf|kj|gs
深圳市振华微电子公司三四七四八二|szs|zh|dz|gs
世台防潮科技深圳有限公司|sz|stfc|kj|gs
深圳弗润德机电有限公司|sz|frd|jd|gs
投资大厦总机物业服务中心|tzds|tzds|tz|zx
深圳市人和实业有限公司|szs|rh|sy|gs
深圳市欧睿实业有限公司|szs|or|sy|gs
深圳市龙岗区坑梓镇计生服务中心|szs|kz|js|zx
深圳市宝安区兴华木器制品厂|szs|xh|mq|zpc
招商银行深圳分行招商银行松岗支行|zs|zsyh|zs|fh
深圳市中博包装材料有限公司业务部|szs|zb|bz|gs
深圳市长寿药业有限公司|szs|cs|yy|gs
招商石化白石洲服务站|zs|zs|zs|fwz
深圳市瑞华五金模具加工中心|szs|rh|wj|zx
一致药店总店深圳市一致医药连锁有限公司巴登店|sz|yz|yd|yd
深圳市粤港通国际货代理有限公司|szs|ygt|gj|gs
深圳市中林实业发展有限公司|szs|zl|sy|gs
深圳市万丰电子有限公司业务|szs|wf|yw|gs
深圳市建升电子有限公司|szs|js|dz|gs
深圳市灿影科技有限公司|szs|cy|kj|gs
深圳市鹏越玩具有限公司|szs|py|wj|gs
深圳市塞诺五金有限公司|szs|sn|wj|gs
周立太律师事务所深圳分所重庆周立太律师事务所深圳分所|sz|zlt|ls|fs
深圳市皇廷电子有限公司|szs|ht|dz|gs
深圳市众诚达电子厂|szs|zcd|dz|dzc
深圳市璇林电子科技有限公司大功率led光源|szs|xl|dz|gs
深圳市振强建设工程管理有限责任公司|szs|zq|jsgc|gs
深圳市安保视科技有限公司销售部|szs|abs|ab|gs
深圳市倾城贸易商行|szs|qc|my|sh
一致药店总店深圳市一致医药连锁有限公司振兴店|sz|yz|yd|yd
深圳市有道文化传播有限公司|szs|yd|wh|gs
美龙翔微电子科技深圳有限公司|sz|mlxw|dz|gs
二天堂大药房圣陶沙分店|sts|ett|yf|fd
深圳市龙岗区启元学校家长咨询|szs|qy|xx|xx
深圳市朝日科技发展有限公司|szs|cr|kj|gs
深圳市龙岗区明达兴轻塑制品厂|szs|mdx|qs|zpc
齐鲁证券深圳吉祥中路营业部|sz|ql|zq|yyb
深圳市环洋通进出口贸易有限公司|szs|hyt|ck|gs
深圳市恒泰五金制品有限公司|szs|ht|wj|gs
深圳市振雄印刷有限公司生产部总机|szs|zx|ys|gs
深圳市可利特科技有限公司|szs|klt|kj|gs
前程教育培训中心横岗分校|hg|qc|jy|zx
深圳市三鼎飞龙电子有限公司|szs|sdfl|dz|gs
深圳市易联科电子有限公司|szs|ylk|dz|gs
深圳玮达电子科技有限公司|sz|wd|dz|gs
山能科技深圳有限公司|sz|sn|kj|gs
双叶金属制品深圳有限公司|sz|sy|js|gs
深圳市京华信息技术有限公司加工合作部|szs|jh|xx|gs
深圳市飞翔复印机租赁服务公司|szs|fx|fy|gs
深圳市宝安区观澜业鑫五金厂|szs|yx|wj|wjc
深圳市格兰航空服务有限公司|szs|gl|hk|gs
深圳市恒安汽车零部件销售商行|szs|ha|qc|sh
深圳市大唐物流有限公司|szs|dt|wl|gs
深圳宏鹰五金厂|sz|hy|wj|wjc
深圳市自然风旅游用品有限公司|szs|zrf|ly|gs
深圳奔流网络公司|sz|bl|wl|gs
深圳市乐麒珠宝有限公司售销部|szs|lq|zb|gs
深圳市杏林春贸易有限公司|szs|xlc|my|gs
深圳市文学艺术界联合会办公室深圳市文学艺术界联合会|sz|szswxysjlhh|bgs|bgs
亚洲大药房笋岗店亚洲医药公司笋岗店春风店|sg|yz|yf|gs
深圳市威浩胶类制品厂|szs|wh|jl|zpc
深圳邮政局咨询投诉桑达代办所|sz|sd|yz|dbs
深圳远望数码商城宏兴通讯行|sz|hx|yw|txx
深圳市信恒誉贸易有限公司|szs|xhy|my|gs
深圳市中菲家政服务有限公司|szs|zf|jz|gs
深圳帝峰回收有限公司|sz|df|hs|gs
深圳市宝安区宏亮吸塑制品厂|szs|hl|xs|zpc
深圳市巨欣文具制造有限公司|szs|jx|wj|gs
深圳市锐网设计有限公司|szs|rw|sj|gs
深圳市新达包装制品厂|szs|xd|bz|zpc
宝中旅行社有限公司深圳市宝安中国旅行社有限公司龙岗中心城营业部|sz|zglxs|lx|gs
深圳市起点体育用品有限公司|szs|qd|ty|gs
深圳市凯瑞奇自动化技术有限公司业务部|szs|krq|zd|gs
新亚洲华昌商铺|xy|zhc|sp|sp
新锦安实业发展深圳有限公司|sz|xja|sy|gs
深圳市亿飞实业有限公司|szs|yf|sy|gs
深圳福龙昌机械设备有限公司|sz|flc|jx|gs
深圳市宝安区盐田天濠电子厂|szs|th|dz|dzc
深圳市祥瑞机械有限公司|szs|xr|jx|gs
深圳市惠宏工艺厂|szs|hh|gy|gyc
深圳万顺达五金制品厂|sz|wsd|wj|zpc
深圳市立铭实业有限公司图文处理|szs|lm|sy|gs
深圳市齐昌实业有限公司市场业务部|szs|qc|sy|gs
深圳市龙岗再生资源有限公司横岗回收站|szs|lg|zs|gs
深圳市东通汽车贸易有限公司售后前台深圳市东通汽车贸易有限公司|szs|dt|qm|gs
深圳市桃源航空服务有限公司|szs|ty|fw|gs
深圳市金创见信息咨询有限公司|szs|jcj|xx|gs
深圳市金湖软件技术有限公司|szs|jh|js|gs
荣利达精密塑胶制品深圳有限公司荣利达精密塑胶制品深圳有限公司|sz|rld|jm|gs
深圳凯普特科技实业有限公司|sz|kpt|kj|gs
深圳市屹天信科科技有限公司|szs|ytxk|kj|gs
深圳市银通机动车驾驶员培训有限公司梅林分校|szs|yt|jd|gs
渣打银行有限责任公司深圳分行客户服务中心|sz|zd|khfw|yh
深圳市万德征信信息技术有限公司二|szs|mdzx|xx|gs
深圳市汤威尔女包手袋皮具有限公司|szs|twe|nb|gs
深圳振昻制衣有限公司|sz|za|zy|gs
深圳先科通信有限公司|sz|xk|tx|gs
银汉大厦租售中心深圳市丰润物业管理有限公司|sz|yh|wygl|zx
宝安区观澜高艺塑胶制品厂|baq|gy|sj|zpc
深圳市通顺财务咨询有限公司会计部|szs|ts|cw|gs
深圳市永顺丰五金机电有限公司|szs|ysf|wj|gs
深圳市伟发塑胶染料有限公司|szs|wf|sj|gs
深圳市帝邦服装有限公司|szs|db|fz|gs
深圳市华夏埃玛电气有限公司|szs|hxam|dq|gs
深圳贝洛安玛蕾娜服饰有限公司|sz|bla|fz|gs
深圳玛西尔电动有限公司|sz|mxe|dd|gs
深圳市黄土地实业有限公司|szs|htd|sy|gs
深圳市宝安区四方制衣厂|szs|sf|zy|zyc
深圳市合协国际贸易有限公司|szs|hx|gj|gs
深圳市诚誉文具批发行|szs|cy|wj|pfx
汇商名苑管理处深圳市鸿华信物业管理有限公司|sz|hsmy|wygl|gs
恒昌模具钢材深圳公司|sz|hc|mj|gs
深圳市广凯讯通信技术有限公司|szs|gkx|tx|gs
深圳市日动精工自动化设备有限公司|szs|rd|jg|gs
深圳市玉乾科技有限公司|szs|yg|kj|gs
深圳市润恒房地产开发有限公司|szs|rh|fdc|gs
深圳市肯泰精密科技有限公司|szs|kt|jm|gs
东湖公园烧烤场|dh|dh|sk|skc
深圳市亿管达五金制品有限公司|szs|ygd|wj|gs
赛霸电子深圳有限公司总机|sz|sb|dz|gs
深圳博雅印花材料厂|sz|by|yh|clc
深圳市南利达五金制品厂|szs|nld|wj|zpc
深圳海昌泰电子市场部|sz|hct|dz|scb
深圳市顶尖饮食管理有限公司胜记饭店胜记酒楼公园店|szs|dj|fd|gs
深圳富利源包装材料有限公司|sz|fly|bz|gs
友利电电子深圳有限公司|sz|yld|dz|gs
深圳市羽齐化妆品有限公司|szs|yq|hz|gs
利达文化用品有限公司平湖分公司|ph|ld|wh|gs
深圳仁孚西湖汽车服务有限公司|sz|rfxh|qc|gs
深圳宇通贸易有限公司深圳服务部|sz|yt|my|gs
深圳市中之电科技公司|szs|zzd|kj|gs
劳伦斯珠宝首饰深圳有限公司|sz|lls|zb|gs
深圳市盈成科技有限公司业务部|szs|yc|kj|gs
宝安区民治街道办事处办公室安全生产监督管理科简称安监科|baq|kjc|bgs|jdb
深圳市农产品坂田肉联厂有限公司|szs|ncp|cp|gs
深圳市金铸城电力设备有限公司|szs|jzc|dl|gs
光大银行深圳分行华侨城支行|sz|gd|yh|yh
深圳市金龙珠宝首饰有限公司|szs|jlz|ss|gs
深圳腾达化工有限公司|sz|td|hg|gs
深圳市宝莱木艺家具有限公司|szs|bl|jj|gs
深圳市金中瑞通讯技术有限公司|szs|jzr|tx|gs
卡骆驰鞋业深圳有限公司|sz|klc|xy|gs
深圳市安和华能源有限公司|szs|ahh|ny|gs
深圳市集鑫汽车销售有限公司|szs|jx|qc|gs
深圳市湘聚实业有限公司|szs|xj|sy|gs
送气频道罗湖区顺威煤气|lh|sw|sq|pd
深圳市盐田港建筑工程检测有限公司三五九一二一|szs|gjz|jzgc|gs
深圳市博尔欣科技有限公司|szs|bex|kj|gs
深圳合顺鑫电子厂|sz|hsx|dz|dzc
普利司通高尔夫深圳有限公司|sz|plst|gef|gs
深圳佳鸿汽车贸易有限公司|sz|jh|qm|gs
深圳通标科技开发有限公司|sz|tb|kj|gs
深圳市惠达电脑耗材有限公司|szs|hd|dn|gs
长城大酒店总机四星|cc|cc|jd|djd
深圳市塑源实业有限公司销售部|szs|sy|sy|gs
深圳市迪雅硅胶制品厂业务部|szs|dy|gj|zpc
万骏房地产深圳有限公司|sz|mj|fdc|gs
深圳科利源科技有限公司销售部|sz|kly|kj|gs
深圳宝加捷国际货代有限公司业务部|sz|bjj|gj|gs
深圳市东迪涂层技术有限公司|szs|dd|js|gs
深圳市深之旅旅游咨询服务有限公司|szs|szl|ly|gs
深圳市吉佳丰贸易有限公司|szs|jjf|my|gs
中国建设银行深圳市分行建设银行华侨城支行华侨城支行|sz|zgjsyh|js|yh
深圳广田装饰集团股份有限公司|sz|gt|zs|jt
深圳市众恒源科技有限公司市场部|szs|zhy|kj|gs
麦当劳深圳市麦当劳餐厅有限公司总部怡景中心城店|sz|mdl|ct|ct
面点王总店中心城店三五九八八五|zxc|zxc|md|zd
深圳市宝安区龙华金龙印刷厂|szs|jl|ys|ysc
深圳市真朝缘商行业务部|szs|zzy|yw|sh
大地通讯设备有限公司总部松岗分部|sg|dd|tx|gs
深圳市蝶蕊科技有限公司|szs|dr|kj|gs
深圳市凡西特服饰有限公司|szs|fxt|fz|gs
深圳市蓬鹏实业有限公司|szs|pp|sy|gs
深圳市富鸿发模特衣架有限公司|szs|fhf|mt|gs
深圳市捷世通物流有限公司|szs|jst|wl|gs
深圳市博贝特科技发展有限公司|szs|bbt|kj|gs
深圳市纳科视讯公司|szs|nk|sx|gs
深圳市润山实业有限公司|szs|rs|sy|gs
深圳市精彩印联合印务有限公司总机深圳市隽扬实业有限公司|szs|jcy|cy|gs
深圳和记隆食品有限公司观兰分厂深圳和记隆食品有限公司深圳和记隆食品有限公司|sz|hjl|sp|gs
深圳市华通电池有限公司|szs|ht|dc|gs
深圳市壹之龙磁电有限公司|szs|yzl|zd|gs
龙岗区科学技术局|lgq|lgq|kxjs|jsj
深圳市业旭实业有限公司业务部|szs|yx|sy|gs
深圳智林科技有限公司|sz|zl|kj|gs
深圳市南山区延煦化玻商行|szs|yx|hb|sh
深圳华富办公用品有限公司|sz|hf|yp|gs
深圳市普林克斯科技有限公司|szs|plks|kj|gs
深圳市龙岗区鸿得精细化工公司销售部|szs|hd|jx|gs
安费诺精密连接器深圳有限公司|sz|afn|jm|gs
深圳市祥兴印刷厂|szs|xx|ys|ysc
深圳市科易连通讯设备有限公司市场部|szs|kyl|tx|gs
深圳市宝路华新辉出租小汽车有限公司监控中心|szs|bl|cz|gs
华联发大厦管理处深圳华联发物业管理有限公司|sz|hlf|wygl|gs
深圳市金联兴电子玩具厂|szs|jlx|dz|wjc
深圳市智芯科技实业有限公司|szs|zx|kj|gs
深圳市华尔纳宾馆|szs|hen|bg|bg
深圳市孙逸仙心血管医院总机心血管医院孙逸仙心血管医院|szs|syx|yy|yy
招商银行深圳分行招商银行宝安支行宝安支行|zs|zsyh|zs|fh
深圳市南众汽车销售服务有限公司|szs|nz|qc|gs
深圳市中合博亿科技有限公司|szs|zhby|kj|gs
万顺达电脑商行深圳市福田区万顺达电脑商行|sz|wsd|dn|sh
新李英玻璃工艺深圳有限公司|sz|xly|bl|gs
深圳大安门诊部健康咨询|sz|da|mzb|mzb
中国工商银行深圳市分行工商银行红宝支行|sz|zggsyx|gs|yh
长江液压技术研究所办事处深圳|sz|cj|yy|yjs
深圳市盈升珠宝有限公司|szs|ys|zb|gs
深圳市国诺科技有限公司|szs|gn|kj|gs
深圳市福田区朱利怀通讯行|szs|zlh|tx|txx
深圳市奥格丽艺术设计有限公司|szs|agl|ys|gs
深圳市恒鑫光电有限公司|szs|hx|gd|gs
深圳市龙岗区鸿达实业有限公司|szs|hd|sy|gs
深圳七色麻服饰有限公司|sz|qsm|fz|gs
深圳市鸿捷雕塑设计有限公司|szs|hj|ds|gs
好景包装制品深圳有限公司业务部|sz|hj|bz|gs
深圳市龙岗区鸿发电子材料商行|szs|hf|dz|sh
深圳万乐药业有限公司|sz|wl|yy|gs
深圳市东大洋混凝土有限公司深圳市东大洋混凝土有限公司|szs|ddy|hnt|gs
展讯通信上海有限公司深圳办事处|sz|zx|szbsc|gs
深圳市艳阳电子有限公司|szs|yy|dz|gs
汕头市亿迪防伪技术开发有限公司深圳分公司|sz|yd|fw|gs
深圳市恒路物流有限公司深圳市恒路物流有限公司|szs|hl|wl|gs
深圳粤新皮具制品厂|sz|yx|pj|zpc
送气频道罗湖区燕鹏石油气布心服务部|lh|yp|sq|pd
深圳市求远达印刷有限公司|szs|qyd|ys|gs
东明仓储服务深圳有限公司原名迪辰仓储服务深圳有限公司|sz|dm|cc|gs
深圳市成霖洁具股份有限公司|szs|cl|jj|gs
深圳市贝思德管理咨询有限公司|szs|bsd|gl|gs
深圳市华信威自动化设备有限公司|szs|hxw|zd|gs
深圳泰生实业公司|sz|ts|sy|gs
深圳市罗湖红骑士富苑网吧|szs|hqsfy|wb|wb
深圳华尔泰科技有限公司|sz|het|kj|gs
永辉集团金属粉材料广东销售第七部|gd|yh|js|dqb
深圳威飞科技有限公司|sz|wf|kj|gs
轮彦公司深圳办|sz|ly|szb|gs
深圳市精创手板厂业务部|szs|jc|sb|sbc
深圳时尚巴黎服装有限公司|sz|bl|ss|gs
深圳市宏展光电科技有限公司|szs|hz|gd|gs
深圳恒浩科技有限公司|sz|hh|kj|gs
深圳市三洋贸易有限公司|szs|sy|my|gs
深圳市中港博美珠宝包装有限公司|szs|zgbm|zb|gs
深圳市新丰益实业股份有限公司|szs|xfy|sy|gs
亿安达空压机深圳有限公司|sz|yad|kqysj|gs
深圳市锐奇电子厂|szs|rq|dz|dzc
深圳市电信局咨询投诉南山电信分局南头机楼查修装机信访可报其他不可报|ns|szsdxj|dx|fj
深圳市声表电子有限公司|szs|sb|dz|gs
深圳市九洲国际旅行社有限公司旅游电话景田营业部|szs|gjlxs|gj|gs
深圳市中圳电气有限公司|szs|zz|dq|gs
深圳市三本化工有限公司|szs|sb|hg|gs
深圳市圳荣建设工程有限公司|szs|zr|jsgc|gs
深圳市帅诚pvc胶袋厂|szs|sc|jd|jdc
蓝欧国际深圳有限公司|sz|lo|gj|gs
深圳飞云航空票务中心|sz|fy|hk|zx
深圳粤东车行贸易有限公司|sz|yd|ch|ch
深圳市广通旧车交易市场|szs|gtjc|jy|sc
深圳艾净洁净装饰工程有限公司|sz|ajjj|zs|gs
深圳市飞速达科技有限责任公司|szs|fsd|kj|gs
深圳市中永发包装制品有限公司|szs|zyf|bz|gs
安其利电子元件深圳有限公司|sz|aql|dz|gs
深圳市侨辉兴业纸品有限公司|szs|qhxy|zp|gs
深圳市宝安区公明阳天电机商行|szs|yt|dj|sh
深圳市泰斯玛信心技术有限公司|szs|ts|js|gs
深圳市俊泽发电子科技有限公司|szs|jzf|dz|gs
深圳市龙岗再生资源有限公司第五站|szs|lg|zs|dwz
深圳芯强电子科技有限公司|sz|xq|dz|gs
深圳市宝安区石岩信兴电热管加工厂|szs|xx|dr|gc
深圳市德贝珠宝首饰有限公司|szs|db|zb|gs
深圳市鹏祺商贸有限责任公司|szs|pq|sm|gs
深圳龙腾电子制品有限公司|sz|lt|zp|gs
深圳市卫尔德实业有限公司三四一六二二|szs|wed|sy|gs
深圳市星铸成标牌厂|szs|zc|bp|bpc
深圳市福尔橡塑有限公司|szs|fe|xs|gs
深圳沃普生科技有限公司销售部|sz|wps|kj|gs
深圳市富创胶袋厂|szs|fc|jd|jdc
深圳市龙岗区平湖镇龙辉达五金模具加工厂|szs|lhd|wj|gc
深圳市联平科技有限公司|szs|lp|kj|gs
深圳诚信康胶粘剂有限公司业务部|sz|cxk|jz|gs
深圳南方宾馆有限公司|sz|nf|bg|bg
深圳鸿佳视电子有限公司|sz|hjs|dz|gs
深圳市燧火科技有限公司三四一二二二|szs|sh|kj|gs
深圳市点盛地产经济有限公司|szs|ds|dc|gs
深圳市润达电子有限公司|szs|rd|dz|gs
深圳奥威新奇特家居用品有限公司|sz|aw|jj|gs
深圳市飞科电子邮箱公司|szs|fk|dz|gs
钡萱服装深圳有限公司|sz|bx|fz|gs
中信大厦管理处深圳市中信物业管理有限公司|zx|zx|wygl|gs
深圳市金力机械设备贸易公司|szs|jl|jx|gs
立鹏科技深圳有限公司|sz|lp|kj|gs
深圳市亨时达实业有限公司|szs|hsd|sy|gs
深圳东瑞紧固件有限公司|sz|dr|gj|gs
深圳市巴士特电子厂|szs|bst|bs|dzc
深圳市建南国际旅行社有限公司|szs|gjlxs|lxs|gs
深圳曼依诺服饰有限公司|sz|myn|fz|gs
深圳市永年首饰品有限公司采购部|szs|yn|ss|gs
深圳富松礼盒制品厂|sz|fs|lh|zpc
美亚国际科技有限公司深圳宝安分公司|sz|my|gj|gs
深圳市碧波中学高中部|szs|bb|gz|gzb
深圳市福田区都会电子市场丰信发电子经营部|szs|dh|dz|sc
深圳市昭俐测量仪器有限公司|szs|zl|cl|gs
杰美康电子深圳有限公司|sz|jmk|dz|gs
深圳狡咤合作公司|sz|jz|hz|gs
深圳华德美塑胶五金包装有限公司|sz|hdm|sj|gs
大展信息科技深圳有限公司|sz|dz|xx|gs
中国网通宝安北营销中心|ba|bab|wt|zx
深圳市久久广告有限公司|szs|jj|gg|gs
深圳睿科科技有限公司|sz|rk|kj|gs
深圳市松源工艺礼品有限公司前台|szs|sy|gy|gs
深圳市誉博科技有限公司|szs|yb|kj|gs
深圳市安姆金属磁电科技有限公司|szs|am|js|gs
港置地产福强分行|fj|gz|dc|fh
深圳市超翔电子塑胶科技开发有限公司|szs|cx|dz|gs
深圳市康尔富科技有限公司|szs|kef|kj|gs
深圳铭泰金属有限公司|sz|mt|js|gs
深圳金蝶软件科技有限公司二六六八七三|sz|jd|rj|gs
深圳市杰夫实业发展有限公司锑部|szs|jf|sy|gs
深圳市宝安区观澜浩然自动化机械制造厂|szs|hr|zd|zzc
深圳市永洪印刷有限公司|szs|yh|ys|gs
深圳市龙达表业有限公司|szs|ld|by|gs
深圳市赛福仓储设备有限公司|szs|sf|cc|gs
深圳市金丹纳科技有限公司销售部|szs|jdn|kj|gs
中信银行深圳分行总行金山支行|zx|zxyh|fh|fh
深圳市船桥航海用品有限公司|szs|cqhh|yp|gs
深圳市宝安区民治立国电热五金配件经营部|szs|mz|lg|jyb
深圳市飞利华电子厂|szs|flh|dz|dzc
深圳市深港通电子有限公司|szs|sgt|dz|gs
深圳市鑫宇佳航物流有限公司|szs|xyjh|wl|gs
深圳市百纳国际货运代理有限公司|szs|bn|gjhy|gs
深圳精彩广告喷绘有限公司|sz|jc|gg|gs
深圳市盛华泰五金制品有限公司|szs|sht|wj|gs
深圳市宝安区公明鼎力锅炉配件部|szs|dl|gl|pjb
深圳市满仓贸易有限公司|szs|mc|my|gs
深圳市攀宏五金制品有限公司|szs|ph|wj|gs
深圳市彭松艺术传媒有限公司|szs|ps|ys|gs
深圳永佳纺织有限公司|sz|yj|fz|gs
赛迪电子深圳有限公司|sz|sd|dz|gs
深圳市摩根国际品牌服装会员店有限公司内衣部|szs|mg|gj|gs
深圳市环奇电子科技有限公司|szs|hq|dz|gs
深圳市龙岗区平湖皓弘塑胶模具制品厂|szs|hh|sj|zpc
深圳市德昌陶瓷工艺品有限公司|szs|dc|tc|gs
深圳市华宇电子材料制品有限公司|szs|hy|dz|gs
深圳市新洋化工实业有限公司|szs|xy|hg|gs
深圳江峰电子贸易行|sz|jf|dz|myx
广东省深圳市时尚前沿服饰公司|sz|qy|fz|gs
深圳市中基环境艺术设计有限公司|szs|zj|hj|gs
深圳和平医院深圳和平医院|sz|hp|yy|yy
深圳市福田区华宫装饰设计有限公司华宫装饰|szs|hg|zs|gs
深圳兴锦鑫电子有限公司|sz|xjx|dz|gs
深圳鑫浩源电子包装材料有限公司|sz|xhy|dz|gs
深圳市万维光电科技有限公司|szs|ww|gd|gs
深圳市靖邦科技有很公司|szs|jb|kj|gs
福立网电子深圳有限公司|sz|flw|dz|gs
深圳市畅想伟业科技有限公司|szs|cx|kj|wy
深圳市南山区疾病预防控制中心|szs|ns|jbyfkzzx|zx
深圳市粤企财税服务有限公司展业三部|szs|yqcs|fw|sb
赐昱鞋业深圳有限公司赐昱鞋业深圳有限公司|sz|cy|xy|gs
深圳市通天地实业有限公司deco德科产品部|szs|ttd|sy|gs
深圳市罗湖区湖晖宾馆|szs|hh|bg|bg
深圳豪威真空光电子股份有限公司深圳豪威真空光电子股份有限公司|sz|hw|zk|gs
深圳市金宝佳科技有限公司业务部|szs|jbj|jb|gs
深圳市保驹汽车服务有限公司|szs|bj|qc|gs
深圳市洋鑫行实业有限公司|szs|yxh|sy|gs
深圳市仲曜科技有限公司|szs|zy|kj|gs
深圳市达昌电子科技有限公司销售二部|szs|dc|dz|eb
深圳市中联专利代理有限公司|szs|zl|zl|gs
愉天小区管理处|yt|ytxq|gl|glc
深圳福田区香格里拉大酒店|ftq|xgll|jd|djd
深圳市互盈贸易有限公司|szs|hy|my|gs
深圳市壹天讯科技有限公司|szs|ytx|kj|gs
中国民生银行中国民生银行深圳分行|ms|zgmsyh|yh|yh
深圳市爱视电子有限公司江苏办事处|szs|as|dz|gs
英联国际不动产福田分行总机|ft|yl|gj|fh
深圳市南山区人民政府区长专线|szs|qz|rmzf|zf
深圳市文信粘合剂厂|szs|wx|nh|nhjc
浪唯智能科技深圳有限公司|sz|lw|zn|gs
深圳市宝鸿林实业有限公司|szs|bhl|sy|gs
腾飞物流国际有限公司深圳办事处|sz|tf|szbsc|gs
旺纬音箱深圳有限公司请报二级旺纬音箱深圳有限公司|sz|ww|yx|gs
上一回转寿司福民店|fm|fm|ss|fmd
深圳市标特汽车有限公司深圳市标特汽车有限公司|szs|bt|qc|gs
深圳市科力腾智能科技有限公司|szs|klt|zn|gs
中国工商银行深圳市分行工商银行华强支行|sz|zggsyx|gs|yh
深圳市华影东方电子有限公司业务部|szs|hy|dz|gs
深圳市卓昊实业有限公司|szs|zh|sy|gs
深圳市易玛服饰有限公司|szs|ym|fz|gs
中国农业银行深圳市分行农业银行红岭北路支行|sz|zgnyyh|ny|yh
深圳利康宝科技有限公司二九五七四零|sz|lkb|kj|gs
深圳市金苹果电子有限公司|szs|jpg|pg|gs
深圳市必拓电子有限公司|szs|bt|dz|gs
深圳市新联发电子科技发展有限公司|szs|xlf|dz|gs
深圳市福田区万商汇电子市场怡星光电子商行|szs|hdz|dz|sc
深圳市辰捷科技有限公司|szs|cj|kj|gs
深圳市鹏飞达印刷有限公司|szs|pfd|ys|gs
深圳市齐亚圣电子有限公司|szs|qys|dz|gs
深圳市康鼎贸易有限公司|szs|kd|my|gs
深圳文兴钢管有限公司深圳商务部|sz|wx|gg|gs
深圳市贝思特实业有限公司|szs|bst|sy|gs
深圳市海翔科科技有限公司|szs|hxk|kj|gs
深圳市裕达化工有限公司|szs|yd|hg|gs
深圳市龙迈科技有限公司|szs|lm|kj|gs
深圳市金牛金属现货网络交易市场有限公司|szs|jn|js|sc
深圳太蓬包装制品有限公司|sz|tp|bz|gs
深圳市自力电子有限公司|szs|zl|dz|gs
深圳市易汇行商贸公司|szs|yhx|sm|gs
祥益实业深圳有限公司|sz|xy|sy|gs
深圳市光喜实业有限公司|szs|gx|sy|gs
深圳市鑫源光电科技有限公司|szs|xy|gd|gs
深圳市国顺科技有限公司科技部|szs|gs|kj|gs
深圳市精亮益威五金有限公司|szs|jlyw|wj|gs
深圳市天研科技有限责任公司|szs|ty|kj|gs
深圳市易成纸业有限公司|szs|yc|zy|gs
深圳市华翊科技有限公司|szs|hy|kj|gs
深圳市佳的美五金电子有限公司|szs|jdm|wj|gs
深圳市大白鸭洗衣店|szs|dby|xy|xyd
深圳市宝安区沙井精益威电子材料经营部|szs|jyw|dz|jyb
深圳市绿叶林珠宝工艺包装有限公司|szs|lyl|zb|gs
深圳市兴安玻璃有限公司|szs|xa|bl|gs
深圳迅宝环保股份有限公司|sz|xb|hb|gs
深圳市博创兴科技邮箱公司|szs|bcx|kj|gs
深圳市索德士体育用品有限公司地胶业务部|szs|sds|ty|gs
深圳市粤嘉鸿电子有限公司咨询处|szs|yjh|dz|gs
深圳市来来淘宝通讯有限公司|szs|lltb|tx|gs
深圳市鹏创电子商行|szs|pc|dz|sh
深圳信诚制刷有限公司|sz|xc|zs|gs
深圳市高佳科技有限公司|szs|gj|kj|gs
安利中国日用品有限公司深圳店|sz|alzg|ry|gs
广发证券股份有限公司原名广东省国际信托证券部蛇口营业部|gd|gf|zq|gs
深圳市红彤凯迪汽车销售服务有限公司深圳市红彤凯迪汽车销售服务公司|szs|htkd|qc|gs
深圳奥安实业有限公司销售部|sz|aa|sy|gs
深圳隆兴五金塑胶废料回收公司|sz|lx|wj|gs
深圳市奥锐包装材料有限公司|szs|ar|bz|gs
悠景科技深圳有限公司|sz|yj|kj|gs
深圳市远泰达实业发展有限公司|szs|ytd|sy|gs
深圳市鸿信服装辅料商行|szs|hx|fz|sh
格瑞希尔电子深圳有限公司|sz|grxe|dz|gs
深圳市明鑫贸易有限公司|szs|mx|my|gs
深圳宝安深燃煤气公司|sz|sr|mq|gs
京基东方都会管理处深圳市广田京基物业管理有限公司|sz|jj|wygl|gs
长城货运公司深圳市长城货运有限公司|cc|cc|hy|gs
深圳市创宏塑胶制品有限公司业务部|szs|ch|sj|gs
深圳市满意清洁有限公司|szs|my|qj|gs
大灰狼餐厅南山店订座狼窝|ns|dhl|ct|ct
深圳市同发顺科技有限公司消费电子事业部|szs|tfs|kj|gs
深圳市铭盛达印刷有限公司|szs|msd|ys|gs
行动成功国际教育集团深圳公司|sz|xdcg|gj|jt
深圳市福田区新亚洲电子市场东迈电子经营部|szs|zdz|dz|sc
深圳市鸿骏达塑胶模具有限公司深圳市鸿骏达塑胶模具有限公司二三九五四八|szs|hjd|sj|gs
深圳暂时性艺术纹身推广中心|sz|zsx|ys|zx
深圳市伽利实业有限公司|szs|jl|sy|gs
深圳市三叶草科技有限公司|szs|syc|kj|gs
确信爱法金属深圳有限公司|sz|qxaf|js|gs
深圳市银泰科技有限公司|szs|yt|kj|gs
铁通深圳分公司服务热线龙岗营业厅|sz|tt|fw|gs
深圳市欣然无纺布制品有限公司|szs|xr|zp|gs
深圳市志信家具有限公司|szs|zx|jj|gs
知库国际贸易深圳有限公司总机|sz|zk|gj|gs
深圳市谷城科技有限公司|szs|gc|kj|gs
安信证券股份有限公司金田营业部三二零七三七|jt|ax|zq|gs
后海名苑居管理处世居物业管理有限公司|hh|myj|wygl|gs
深圳市恒基彩色印刷有限公司|szs|hj|cs|gs
深圳市顺顺发搬家服务有限公司|szs|ssf|bj|gs
深圳市泰利依莱光电有限公司二|szs|tlyl|gd|gs
深圳市福田区腾跃电子商行|szs|ty|dz|sh
深圳市胜蓝精密模具制品厂|szs|sl|jm|zpc
深圳市珍爱网信息技术有限公司深圳总部|szs|zaw|xx|gs
深圳市诚信丰粘胶制品有限公司业务部|szs|cxf|zj|gs
华南城航空服务有限公司大冲售票处|hn|ch|spc|spc
深圳市科讯教育咨询有限公司|szs|kx|jy|gs
深圳市金成礼品有限公司|szs|jc|lp|gs
深圳市拓源科技电子有限公司|szs|ty|kj|gs
深圳市电信局咨询投诉罗湖电信分局东湖机楼查修装机信访可报其他不可报|lh|szsdxj|dx|fj
深圳云太精密模切制品有限公司|sz|yt|jm|gs
译佰深圳翻译公司业务部|sz|yb|fy|gs
深圳三洋华强能源有限公司|sz|sy|ny|gs
深圳市鹏峰贸易有限公司深圳市鹏峰贸易有限公司|szs|pf|my|gs
深圳市凌启贸易有限公司|szs|lq|my|gs
深圳市豪鹏电池有限公司|szs|hp|dc|gs
宝安区卫生局龙华卫生监督所预防保健所|baq|ba|ws|wsj
深圳市德能达科技有限公司|szs|dnd|kj|gs
